Loma - A Soul Music Love Affair Volume Two Get In The Groove 1965-68
Loma - A Soul Music Love Affair Volume Three Sad Sad Feeling 1964-68
 Les Nouveaux  Jaguards - Pour Le Danse
A Certain Ratio- acrmcr
A Perfect Circle- Eat The Elephant  Limited Edition 2-LP RedBlue Colored Vinyl
Abrams Casey- I Put A Spell On You
ACDC - Rock Or BustAbrams Casey- I Put A Spell On You
ACDC - Rock Or Bust
Adam Ant- Adam Ant is the Blue Black Hussar in Marrying the Gunners Daughter
Alt-J - This Is All Yours New
Alabama Shakes - Sounds and Color
AkronFamily - bmbz 
Allen Woody - The Night Club Years 1964-68
Zomby Zomby - Livity
Aparicio Emilio- Expansion Gallactica
Anthony And The Johnsons - I Am A Bird Now
Animal Collective - Merriweather Post Pavillion
Badly Drawn Boy - About A Boy OST
Badalmenti Angelo - Twin Peaks OST
Beach Boys - Pet Sounds  Scorpio 
Banksy 2018 Calendar
Battiato - Sulle Corde Di Arias
Badru Aisha- Pendulum
Bad Luck Jonathan - ST
Arocena Dayme - Cubafornia
Atmosphere - You Cant Imagine How Much Fun Were Having  10 Year Anniversary Edition  4LP Green and Red Vinyl 
At The Drive In - Interalia
Art FarmerJim Hall - Big Blues
Arrested Development- 3Years 5months and 2 Days in the Life of... 25th Ann.
Massive Attack and Mad Professor - No Protection
